1111111111111111111111111111111111
1E0010000000000000100000010F000001
1010110100100000101000000000010101
100011001010101000100100010001F101
1F00000000000000000000000100000001
10100000C0000000111P11111111111111
1111000111110000000000000100101111
1111111111111111111111111111111111
