1111111111111111111111111111111111
1E0000000000000C00100C00010F000001
10100101001000001010000000P0010101
100001001010101000100100010001F101
1F0000000C00C0000000000001000000C1
1111111111111111111111111111111111
1111111111111111111111111111111111
1111111111111111111111111111111111
