1111111111111111111111111111111111
1E0000000000000C00100C00010F000001
1010010100100000101001000000010101
1F10010010101010001001000100010101
1P0000F00C00C0000000000001000000C1
1111111111111111111111111111111111
