1111111111111
10F0000010001
1C001E00CC001
1P0001100F001
1111111111111